S011111111111101
1010000010000101
1011010110101101
1011010110101101
1111010110101111
1001010110101101
1001010110101101
1001010110101101
1011110110111101
1111101111011111
1111101001010001
1000101001010001
101111100111110E