0 0 0 0 0 0 0 0 0 0 0 0 0 0 0 0 0
0 0 1 0 0 1 1 1 1 0 0 1 1 0 0 0 0
0 0 1 1 1 1 1 1 0 0 0 0 1 0 0 1 0
0 0 1 0 0 1 0 1 1 0 0 1 0 1 1 0 0
0 1 1 0 1 S 1 1 1 E 0 0 1 1 0 0 0
0 0 0 1 0 0 1 1 0 1 1 0 1 1 1 0 0
0 0 1 1 0 0 0 1 0 0 C2 0 1 1 0 1 0
0 1 0 0 1 1 0 0 0 0 0 1 0 1 1 0 0
0 0 0 0 1 0 0 1 0 0 1 C3 1 0 1 0 0
0 0 0 0 0 1 0 0 1 1 0 0 0 0 1 0 0
0 0 C1 1 0 0 0 0 1 0 1 1 0 0 0 1 0
0 1 1 1 1 0 1 1 1 1 1 0 0 0 0 0 0
0 0 0 0 0 0 1 0 0 1 0 0 1 1 0 0 0
0 0 1 1 1 1 0 0 0 0 0 1 0 0 0 0 0
0 0 0 0 0 0 0 0 0 0 0 0 0 0 0 0 0